"aa" = (/turf/Terrain/DDGrass,/area)
"ab" = (/turf/Terrain/DGrass,/turf/sides/ddgsouth,/turf/sides/ddgwest,/turf/sides/ddgeast,/area)
"ac" = (/turf/Terrain/DGrass,/turf/sides/ddgsouth,/turf/sides/ddgeast,/area)
"ad" = (/turf/Terrain/DGrass,/turf/sides/ddgnorth,/turf/sides/ddgsouth,/area)
"ae" = (/turf/Terrain/DGrass,/turf/sides/ddgsouth,/turf/sides/ddgwest,/area)
"af" = (/maptag{tag = "white_team"},/turf/Terrain/DDGrass,/area)
"ag" = (/turf/Terrain/DGrass,/turf/sides/ddgeast,/turf/sides/ddgsouth,/area)
"ah" = (/turf/Terrain/DGrass,/turf/sides/ddgsouth,/area)
"ai" = (/turf/Terrain/DGrass,/turf/sides/ddgwest,/turf/sides/ddgsouth,/area)
"aj" = (/turf/Terrain/DGrass,/turf/sides/ddgnorth,/turf/sides/ddgeast,/area)
"ak" = (/turf/Terrain/DGrass,/turf/sides/ddgeast,/turf/sides/ddgwest,/area)
"al" = (/turf/Terrain/DGrass,/turf/sides/ddgnorth,/turf/sides/ddgsouth,/turf/sides/ddgwest,/area)
"am" = (/turf/Terrain/DGrass,/area)
"an" = (/turf/Terrain/DGrass,/turf/sides/ddgwest,/turf/sides/ddgnorth,/turf/sides/ddgsouth,/area)
"ao" = (/turf/Terrain/DGrass,/turf/sides/ddgnorth,/turf/sides/ddgsouth,/turf/sides/ddgeast,/area)
"ap" = (/turf/Terrain/DGrass,/turf/sides/ddgeast,/area)
"aq" = (/turf/Terrain/DGrass,/turf/sides/ddgnorth,/turf/sides/ddgwest,/area)
"ar" = (/turf/Terrain/DGrass,/turf/sides/ddgnorth,/area)
"as" = (/turf/Terrain/DGrass,/turf/sides/ddgwest,/area)
"at" = (/turf/Terrain/DGrass,/turf/sides/ddgwest,/turf/sides/ddgnorth,/area)
"au" = (/turf/Terrain/DGrass,/turf/sides/ddgeast,/turf/sides/ddgwest,/turf/sides/ddgsouth,/turf/sides/ddgnorth,/area)
"av" = (/turf/Terrain/DGrass,/turf/sides/ddgnorth,/turf/sides/ddgeast,/turf/sides/ddgwest,/area)
"aw" = (/turf/Terrain/DGrass,/turf/sides/ddgwest,/turf/sides/ddgsouth,/turf/sides/ddgeast,/area)
"ax" = (/turf/Terrain/DGrass,/turf/sides/ddgwest,/turf/sides/ddgeast,/area)
"ay" = (/turf/Terrain/DGrass,/turf/sides/ddgwest,/turf/sides/ddgeast,/turf/sides/ddgnorth,/area)
"az" = (/turf/Terrain/DGrass,/turf/sides/ddgsouth,/turf/sides/ddgnorth,/turf/sides/ddgwest,/turf/sides/ddgeast,/area)
"aA" = (/turf/Terrain/DGrass,/turf/sides/ddgsouth,/turf/sides/ddgeast,/turf/sides/ddgnorth,/area)
"aB" = (/turf/Terrain/DGrass,/turf/sides/ddgsouth,/turf/sides/ddgnorth,/area)
"aC" = (/turf/Terrain/DGrass,/turf/sides/ddgnorth,/turf/sides/ddgeast,/turf/sides/ddgwest,/turf/sides/ddgeast,/area)
"aD" = (/turf/Terrain/DGrass,/turf/sides/ddgsouth,/turf/sides/ddgnorth,/turf/sides/ddgeast,/turf/sides/ddgwest,/area)
"aE" = (/turf/Terrain/DGrass,/turf/sides/ddgnorth,/turf/sides/ddgeast,/turf/sides/ddgsouth,/area)
"aF" = (/turf/Terrain/DGrass,/turf/sides/ddgsouth,/turf/sides/ddgeast,/turf/sides/ddgwest,/area)
"aG" = (/turf/Terrain/DGrass,/turf/sides/ddgsouth,/turf/sides/ddgnorth,/turf/sides/ddgwest,/area)
"aH" = (/turf/Terrain/DGrass,/turf/sides/ddgeast,/turf/sides/ddgnorth,/area)
"aI" = (/turf/Terrain/DGrass,/turf/sides/ddgwest,/turf/sides/ddgsouth,/turf/sides/ddgeast,/turf/sides/ddgnorth,/area)
"aJ" = (/turf/Terrain/DGrass,/turf/sides/ddgeast,/turf/sides/ddgnorth,/turf/sides/ddgsouth,/area)
"aK" = (/turf/Terrain/DGrass,/turf/sides/ddgwest,/turf/sides/ddgeast,/turf/sides/ddgnorth,/turf/sides/ddgsouth,/area)
"aL" = (/turf/Terrain/DGrass,/turf/sides/ddgeast,/turf/sides/ddgwest,/turf/sides/ddgsouth,/area)
"aM" = (/turf/Terrain/DGrass,/turf/sides/ddgeast,/turf/sides/ddgsouth,/turf/sides/ddgnorth,/area)
"aN" = (/turf/Terrain/DGrass,/turf/sides/ddgwest,/turf/sides/ddgsouth,/turf/sides/ddgnorth,/area)
"aO" = (/maptag{tag = "black_team"},/turf/Terrain/DDGrass,/area)
"aP" = (/turf/Terrain/DGrass,/turf/sides/ddgwest,/turf/sides/ddgnorth,/turf/sides/ddgeast,/area)
"aQ" = (/turf/dense_dark,/area)
"aR" = (/turf/dense_dark,/area/nopkzone)
"aS" = (/turf/indoor/walls/sided,/turf/dense_dark,/area/nopkzone)
"aT" = (/turf/indoor/walls/corner4,/turf/dense_dark,/area/nopkzone)
"aU" = (/turf/indoor/walls/sidel,/area/nopkzone)
"aV" = (/turf/indoor/walls/t1,/area/nopkzone)
"aW" = (/turf/indoor/walls/t2,/area/nopkzone)
"aX" = (/turf/indoor/walls/t3,/area/nopkzone)
"aY" = (/turf/indoor/walls/sider,/area/nopkzone)
"aZ" = (/turf/indoor/walls/b1,/area/nopkzone)
"ba" = (/obj/sale/Zabuza_Sword,/turf/indoor/walls/b2,/area/nopkzone)
"bb" = (/turf/indoor/walls/b2,/area/nopkzone)
"bc" = (/turf/indoor/walls/b3,/area/nopkzone)
"bd" = (/obj/sale/Caltrop,/turf/indoor/floor/marble,/area/nopkzone)
"be" = (/obj/sale/Tripwire,/turf/indoor/floor/marble,/area/nopkzone)
"bf" = (/obj/sale/Anbu_Sword,/turf/indoor/floor/marble,/area/nopkzone)
"bg" = (/turf/indoor/floor/marble,/area/nopkzone)
"bh" = (/obj/sale/Bandage,/turf/indoor/floor/marble,/area/nopkzone)
"bi" = (/obj/sale/SupplyScroll,/turf/indoor/floor/marble,/area/nopkzone)
"bj" = (/obj/sale/SoldierPill,/turf/indoor/floor/marble,/area/nopkzone)
"bk" = (/obj/Nevermind,/turf/indoor/floor/marble,/area/nopkzone)
"bl" = (/mob/human/npc/shopnpc,/turf/indoor/floor/marble,/area/nopkzone)
"bm" = (/maptag{tag = "tdm_waiting"},/turf/indoor/floor/marble,/area/nopkzone)
"bn" = (/turf/indoor/walls/b2,/turf/indoor/walls/sideu,/area/nopkzone)
"bo" = (/turf/indoor/walls/sider,/turf/indoor/walls/corner1,/area/nopkzone)
"bp" = (/turf/denseempty,/area)

(1,1,1) = {"
aaaaaaaaaaaaaaaaaaaaaaaaaaaaaaaaaaaaaaaaaaaaaaaaaaaaaaaaaaaaaaaaaaaaaaaaaaaaaaaaaaaaaaaaaaaaaaaaaaaa
aaaaaaaaaaaaaaabaaaaaaacadadaeaaaaaaaaaaaaaaaaaaafaaaaaaaaaaaaaaaaaaaaaaaaaaaaaaaaaaagahaiaaaaaaaaaa
aaaaaaaaaaaaaaajaeaaaaakaaaaakaaaaacadalaaaaaaaaaaaaaaaaaaaaaaaaaaaaaaaaaaaaaaaaaaagamamamanaaaaaaaa
aaaaaaaaaoalaaaaapahahamahahamahahaqaaaaaaaaaaaaaaaaaaaaaaaaaaaaaaaaaaaaaaaaaaaaaaajaramasaaaaaaaaaa
aaaaaaaaaaaaaoahamamamamamamamamasaaaaaaaaaaaaaaaaaaaaaaaaaaaaaaaaaaaaaaaaaaaaaaaaaaaaajamahaiaaaaaa
aaaaaaaaaaaaaaapamamamamamamamamasaaaaaaaaaaaaaaaaaaaaaaaaaaaaaaaaaaaaaaaaaaaaaaaaaaaaaaajarataaaaaa
aaaaaaaaaaaaaaaparamamamamamamamasaaaaaaaaaaaaaaaaaaaaaaaaaaaaaaaaauaaaaaaaaaaaaaaaaaaaaaaaaaaaaaaaa
aaaaaaaaaaaaapaqaaapamamamamamamamaeaaaaaaaaaaaaaaaaaaaaaaaaaaaaaaaaaaaaaaaaaaaaaaaaaaaaaaaaaaaaaaaa
aaaaaaaaaaaaavaaaaapamamamamamararasaaaaaaaaaaaaaaaaaaaaaaaaaaaaaaauaaaaaaaaaaaaaaaaaaaaaaaaaaaaaaaa
aaaaaaaaaaaaaaaaaaapamararararaaaaajaeaaaaaaaaaaaaaaaaaaaaaaaaaaaaaaaaaaaaaaaaabaaaaaaaaaaaaaaaaaaaa
aaaaaaaaaaaaaaaaaaajasaaaaaaaaaaaaaaavaaaaaaaaaaaaaaaaaaaaaaaaaaaaawaaaaaaaaaaaxaaaaaaaaaaaaaaaaaaaa
aaaaaaaaaaaaaaaaaaaaaxaaaaaaaaaaaaaaaaaaaaaaaaaaaaaaaaaaaaaaaaaaaaapahahahaeaaaxaaaaaaaaaaaaaaaaaaaa
aaaaaaaaaaaaaaaaaaaaaxaaaaaaaaaaaaaaaaaaaaaaaaaaaaaaaaaaaaaaaaaaagamamamamamahamadahaeaaaaaaaaaaaaaa
aaaaaaaaaaaaaaaaaaaaayaaaaaaaaaaaaaaaaaaaaaaaaaaaaazaaaaazaaazaaapamamamamamamasaaapaqaaaaaaaaaaaaaa
aaaaaaaaaaaaaaaaaaaaaaaaaaaaaaaaaaaaaaaaaaaaaaaaaaaaaaaaaaaaaaaaapamamamamamamasaaaxaaaaaaaaaaaaaaaa
aaaaaaaaaaaaaaaaaaaaaaaaaaaaaaaaaaaaaaaaaaaaaaaaaaaaaaaaaaaaaAaBamamamamamamamamahaqaaaaaaaaaaaaaaaa
aaaaaaaaaaaaaaaaaaaaaaaaaaaaaaaaaaaaaaaaaaaaaaaaaaaaaaaaaaaaaaaaapamamamamamamamaqaaaaaaaaaaaaaaaaaa
aaaaaaaaaaaaaaaaaaaaaaaaaaaaaaaaaaaaaaaaaaaaaaaaaaaaaaaaaaaaaaaaapamamamamamamasaaaaaaaaaaaaaaaaaaaa
aaaaaaaaaaaaaaaaaaaaaaaaaaaaaaaaaaaaaaaaaaaaaaaaaaaaaaaaaaaaacahamaramarararamaqaaaaaaaaaaaaaaaaaaaa
aaaaaaaaaaaaaaaaaaaaaaaaaaaaaaaaaaaaaaaaaaaaaaaaaaaaaaaaaaaaaparaqaaaCaaaaaaavaaaaaaaaaaaaaaaaaaaaaa
aaaaaaaaaDaaaaaaaaakaaaaaaaDaaaaaaaaaaaaaaaaaaaaaaaaaaaaaaaaavaaaaaaaaaEalaaaaaaaaaaaaaaaaaaaaaaaaaa
aaaaaaaaaaacaaaaaaakaaaoalaaaaaaaaaaaaaaaaaaaaaaaaaaaaaaaaaaaaaaaaaaaaaaaaaaaaaaaaaaaaaaaaaaaaaaaaaa
aaaaaaaFaaapaeaaaaakaaaaaaaaaaaaaaaaaaaaaaaaaaaaaaaaaaaaaaaaaaaaaaaaaaaaaaaaaaaaaaaaaaaaaaaaaaaaaaaa
aaaaaaajahamamahahamahaeaaaaaaaaaaaaaaaaaaaaaaaaaaaaaaaaaaaaaaaaaaaaaaaaaaaaaaaaaaaaaaaaaaaaaaaaaaaa
aaaaaaaaapamamamamamamasaaaaaaaaaaaaaaaaaaaaaaaaaaaaaaaaaaaaaaaaaaaaaaaaaaaaaaaaaaaaaaaaaaaaaaaaaaaa
aaaaaaaaapamamamamamamamaBaBaBaGaaaaaaaaaaaaaaaaaaaaaaaaaaaaaaaaaaaaaaaaaaaaaaaaaaaaaaaaaaaaaaaaaaaa
aaaaaaacarararararamamasaaaaaaaaaaaaaaaaaaaaaaaaaaaaaaaaaaaaaaaaaaaaaaaaaaaaaaaaaaaaaaaaaaaaaaaaaaaa
aaaaaaavaaaaaaaaaaajaraqaaaaaaaaaaaaaaaaaaaaaaaaaaaaaaaaaaaaaaaaaaaaaaaaaaaaaaaaaaaaaaaaaaaaaaaaaaaa
aaaaaaaaaaaaaaaaaaaaaaaaaaaaaaaaaaaaaaaaaaaaaaaaagahaiaaaaaaaaaaaaaaaaaaaaaaaaaaaaaaaaaaaaaaaaaaaaaa
aaaaaaaaaaaaaaaaaaaaaaaaaaaaaaaaaaaaaaaaaaaaaaaaapamamahahahaiaaagadadanaaaaaaaaaaaaaaaaaaaaaaaaaaaa
aaaaaaaaaaaaaaaaaaaaaaaaaaaaaaaaaaaaaaaaaaaaaaaaaHamamamamamamahasaaaaaaaaaaaaaaaaaaaaaaaaaaaaaaaaaa
aaaaaaaaaaaaaaaaaaaaaaaaaaaaaaaaaaaaaaaaaaaaaaaaaaapamamamamamamamaiaaaaaaaaaaaaaaaaaaaaaaaaaaaaaaaa
aaaaaaaaaaaaaaaaaaaaaaaaaaaaaaaaaaaaaaaaaaaaaaaaaaapamamamamamamamasaaaaaaaaaaaaaaaaaIaaaaaIaaaaaaaa
aaaaaaaaaaaxaaaaaaaaaaaaaaaaaaaaaaaaaaaaaaaaaaaaaaapamamamamamamamamaiaaaaaaaaaaaaaaaaaaaaaaaaabaaaa
aaaaaaaaaaaxaaaaaaaaaaaaaaaaaaaaaaaaaaaaaaaaaaaJadamamamamamamamamamataaaaaaaaaaaaaaaaaaagahahaqaaaa
aaaaagahahasaaaaaaaaaaaaaaaaaaaaaaaaaaaaaaaJanaaaaapamamamamamararataaaaaaaaaaaaaaaaaaagamamasaaaaaa
aaaaapamamasaaaaaaaaaaaaaaaaaaaaaaaaaaaganaaaaaaaaaHamarararaqaaaaaaaaaaaaaaaaaaaaaaaaaHamaraqaaaaaa
aaaaapamamasaaaaaaaaaaaaaaaaaaaaaaaaaaaxaaaaaaaaaaaaayaaaaaaaaaaaaaKaaaaaaaaaaaaaaaaaaaaakaaaaaaaaaa
aaapamamamamahaBaGaaaaaaaaaaaaaaaaaaaaayaaaaaaaaaaaaaaaaaaaaaaaaaaaaaaaaaaaaaaaaaaaaaaaaakaaaaaaaaaa
aaajamamamamaqaaaaaaaaaaaaaaaaaaaaaaaaaaaaaaaaaaaaaaaaaaaaaaaaaaaaaaaKaaaaaaaaaaaaaaaaaaaaaaaaaaaaaa
aaaaapamamasaaaaaaaaaaaaaaaaacalaaaaaaaaaaaaaaaaaaaaaaaaaaaaaaaaaaaaaaaaaaaaaaaaaaaaaaaaaaaaaaaaaaaa
aaaaapamamasaaaaaaaaaaaFaaaaakaaaaaaaaaaaaaaaaaaaaaaaaaaaaaaaaaaaaaaaaaaaaaaaaaaaaaaaaaaaaaaaaaaaaaa
aaagarararataaaaaaaaaaajahahamadanaaaaaaaaaaaaaaaaaaaLaaaaaaaaaaaaaaaaaaaaaaaaaaaaaaaaaaaaaaaaaaaaaa
aaavaaaaaaaaaaaaaaaaaaaaapamasaaaaaaaaaaaaaaaaaaaaaaaHaiaaaaaaaaaaaaaMaBaiaaaaaaaaaaaaaaaaaaaaaaaaaa
aaaaaaaaaaaaaaaaaaaaaaaaapamataaaaaaaaaaaaaaaaaaaaaaaaakaaaaaaaaaaaaaaaaapahahahahaNaaaaaaaaaaaaaaaa
aaaaaaaaaaaaaaaaaaaaaaaaapasaaaaaaaaaaaaaaaaaaaaaaaaaaaHaiaaacahaiaaaaagamamamamasaaaaaaaaaaaaaaaaaa
aaaaaaaaaaaaaaaaaaaaaaaaapamaiaaaaaaaaaaaaaaaaaaaaaaaaaaapahamamamahahamamamamamamahaiaaaaaaaaaaaaaa
aaaaaaaaaaaaaaaaaaaaaaaaapamasaaaaaaaaaaaaaaaaaaaaaaaaaaapamamamamamamamamamamamamamasaaaaaaaaaaaaaa
aaaaaaaaaaaaaaaaaaaaaaaaajarasaaaaaaaaaaaaaaaaaaaOaaaaaaaHarararamarararararamamamamasaaaaaaaaaaaaaa
aaaaaaaaaaaaaaaaaaaaaaaaaaaaapaiaaaaaaaaaaaaaaaaaaaaaaaaaaaaaaaaaPaaaaaaaaaaapamamamamaiaaaaaaaaaaaa
"}

(1,1,2) = {"
aQaQaQaQaQaQaQaQaQaQaQaRaSaSaSaSaSaSaSaSaSaSaSaSaSaSaSaSaSaTaQaQaQaQaQaQaQaQaQaQaQaQaQaQaQaQaQaQaQaQ
aQaQaQaQaQaQaQaQaQaQaQaUaVaWaWaWaWaWaWaWaWaWaWaWaWaWaWaWaXaYaQaQaQaQaQaQaQaQaQaQaQaQaQaQaQaQaQaQaQaQ
aQaQaQaQaQaQaQaQaQaQaQaUaZbabbbbbbbbbbbbbbbbbbbbbbbbbbbbbcaYaQaQaQaQaQaQaQaQaQaQaQaQaQaQaQaQaQaQaQaQ
aQaQaQaQaQaQaQaQaQaQaQaUbdbebfbgbgbgbgbgbgbgbgbgbgbgbgbgbgaYaQaQaQaQaQaQaQaQaQaQaQaQaQaQaQaQaQaQaQaQ
aQaQaQaQaQaQaQaQaQaQaQaUbhbibjbgbgbgbgbgbgbgbgbgbgbgbgbgbgaYaQaQaQaQaQaQaQaQaQaQaQaQaQaQaQaQaQaQaQaQ
aQaQaQaQaQaQaQaQaQaQaQaUbkblbkbgbgbgbgbgbgbgbgbgbgbgbgbgbgaYaQaQaQaQaQaQaQaQaQaQaQaQaQaQaQaQaQaQaQaQ
aQaQaQaQaQaQaQaQaQaQaQaUbgbgbgbgbgbgbgbgbgbgbgbgbgbgbgbgbgaYaQaQaQaQaQaQaQaQaQaQaQaQaQaQaQaQaQaQaQaQ
aQaQaQaQaQaQaQaQaQaQaQaUbgbgbgbgbgbgbgbgbmbgbgbgbgbgbgbgbgaYaQaQaQaQaQaQaQaQaQaQaQaQaQaQaQaQaQaQaQaQ
aQaQaQaQaQaQaQaQaQaQaQaUbgbgbgbgbgbgbgbgbgbgbgbgbgbgbgbgbgaYaQaQaQaQaQaQaQaQaQaQaQaQaQaQaQaQaQaQaQaQ
aQaQaQaQaQaQaQaQaQaQaQaUbgbgbgbgbgbgbgbgbgbgbgbgbgbgbgbgbgaYaQaQaQaQaQaQaQaQaQaQaQaQaQaQaQaQaQaQaQaQ
aQaQaQaQaQaQaQaQaQaQaQaUbgbgbgbgbgbgbgbgbgbgbgbgbgbgbgbgbgaYaQaQaQaQaQaQaQaQaQaQaQaQaQaQaQaQaQaQaQaQ
aQaQaQaQaQaQaQaQaQaQaQaUbgbgbgbgbgbgbgbgbgbgbgbgbgbgbgbgbgaYaQaQaQaQaQaQaQaQaQaQaQaQaQaQaQaQaQaQaQaQ
aQaQaQaQaQaQaQaQaQaQaQaUbgbgbgbgbgbgbgbgbgbgbgbgbgbgbgbgbgaYaQaQaQaQaQaQaQaQaQaQaQaQaQaQaQaQaQaQaQaQ
aQaQaQaQaQaQaQaQaQaQaQaUbnbnbnbnbnbnbnbnbnbnbnbnbnbnbnbnbnboaQaQaQaQaQaQaQaQaQaQaQaQaQaQaQaQaQaQaQaQ
aQaQaQaQaQaQaQaQaQaQaQaQaQaQaQaQaQaQaQaQaQaQaQaQaQaQaQaQaQaQaQaQaQaQaQaQaQaQaQaQaQaQaQaQaQaQaQaQaQaQ
aQaQaQaQaQaQaQaQaQaQaQaQaQaQaQaQaQaQaQaQaQaQaQaQaQaQaQaQaQaQaQaQaQaQaQaQaQaQaQaQaQaQaQaQaQaQaQaQaQaQ
aQaQaQaQaQaQaQaQaQaQaQaQaQaQaQaQaQaQaQaQaQaQaQaQaQaQaQaQaQaQaQaQaQaQaQaQaQaQaQaQaQaQaQaQaQaQaQaQaQaQ
aQaQaQaQaQaQaQaQaQaQaQaQaQaQaQaQaQaQaQaQaQaQaQaQaQaQaQaQaQaQaQaQaQaQaQaQaQaQaQaQaQaQaQaQaQaQaQaQaQaQ
aQaQaQaQaQaQaQaQaQaQaQaQaQaQaQaQaQaQaQaQaQaQaQaQaQaQaQaQaQaQaQaQaQaQaQaQaQaQaQaQaQaQaQaQaQaQaQaQaQaQ
aQaQaQaQaQaQaQaQaQaQaQaQaQaQaQaQaQaQaQaQaQaQaQaQaQaQaQaQaQaQaQaQaQaQaQaQaQaQaQaQaQaQaQaQaQaQaQaQaQaQ
aQaQaQaQaQaQaQaQaQaQaQaQaQaQaQaQaQaQaQaQaQaQaQaQaQaQaQaQaQaQaQaQaQaQaQaQaQaQaQaQaQaQaQaQaQaQaQaQaQaQ
aQaQaQaQaQaQaQaQaQaQaQaQaQaQaQaQaQaQaQaQaQaQaQaQaQaQaQaQaQaQaQaQaQaQaQaQaQaQaQaQaQaQaQaQaQaQaQaQaQaQ
aQaQaQaQaQaQaQaQaQaQaQaQaQaQaQaQaQaQaQaQaQaQaQaQaQaQaQaQaQaQaQaQaQaQaQaQaQaQaQaQaQaQaQaQaQaQaQaQaQaQ
aQaQaQaQaQaQaQaQaQaQaQaQaQaQaQaQaQaQaQaQaQaQaQaQaQaQaQaQaQaQaQaQaQaQaQaQaQaQaQaQaQaQaQaQaQaQaQaQaQaQ
aQaQaQaQaQaQaQaQaQaQaQaQaQaQaQaQaQaQaQaQaQaQaQaQaQaQaQaQaQaQaQaQaQaQaQaQaQaQaQaQaQaQaQaQaQaQaQaQaQaQ
aQaQaQaQaQaQaQaQaQaQaQaQaQaQaQaQaQaQaQaQaQaQaQaQaQaQaQaQaQaQaQaQaQaQaQaQaQaQaQaQaQaQaQaQaQaQaQaQaQaQ
aQaQaQaQaQaQaQaQaQaQaQaQaQaQaQaQaQaQaQaQaQaQaQaQaQaQaQaQaQaQaQaQaQaQaQaQaQaQaQaQaQaQaQaQaQaQaQaQaQaQ
aQaQaQaQaQaQaQaQaQaQaQaQaQaQaQaQaQaQaQaQaQaQaQaQaQaQaQaQaQaQaQaQaQaQaQaQaQaQaQaQaQaQaQaQaQaQaQaQaQaQ
aQaQaQaQaQaQaQaQaQaQaQaQaQaQaQaQaQaQaQaQaQaQaQaQaQaQaQaQaQaQaQaQaQaQaQaQaQaQaQaQaQaQaQaQaQaQaQaQaQaQ
aQaQaQaQaQaQaQaQaQaQaQaQaQaQaQaQaQaQaQaQaQaQaQaQaQaQaQaQaQaQaQaQaQaQaQaQaQaQaQaQaQaQaQaQaQaQaQaQaQaQ
aQaQaQaQaQaQaQaQaQaQaQaQaQaQaQaQaQaQaQaQaQaQaQaQaQaQaQaQaQaQaQaQaQaQaQaQaQaQaQaQaQaQaQaQaQaQaQaQaQaQ
aQaQaQaQaQaQaQaQaQaQaQaQaQaQaQaQaQaQaQaQaQaQaQaQaQaQaQaQaQaQaQaQaQaQaQaQaQaQaQaQaQaQaQaQaQaQaQaQaQaQ
aQaQaQaQaQaQaQaQaQaQaQaQaQaQaQaQaQaQaQaQaQaQaQaQaQaQaQaQaQaQaQaQaQaQaQaQaQaQaQaQaQaQaQaQaQaQaQaQaQaQ
aQaQaQaQaQaQaQaQaQaQaQaQaQaQaQaQaQaQaQaQaQaQaQaQaQaQaQaQaQaQaQaQaQaQaQaQaQaQaQaQaQaQaQaQaQaQaQaQaQaQ
aQaQaQaQaQaQaQaQaQaQaQaQaQaQaQaQaQaQaQaQaQaQaQaQaQaQaQaQaQaQaQaQaQaQaQaQaQaQaQaQaQaQaQaQaQaQaQaQaQaQ
aQaQaQaQaQaQaQaQaQaQaQaQaQaQaQaQaQaQaQaQaQaQaQaQaQaQaQaQaQaQaQaQaQaQaQaQaQaQaQaQaQaQaQaQaQaQaQaQaQaQ
aQaQaQaQaQaQaQaQaQaQaQaQaQaQaQaQaQaQaQaQaQaQaQaQaQaQaQaQaQaQaQaQaQaQaQaQaQaQaQaQaQaQaQaQaQaQaQaQaQaQ
aQaQaQaQaQaQaQaQaQaQaQaQaQaQaQaQaQaQaQaQaQaQaQaQaQaQaQaQaQaQaQaQaQaQaQaQaQaQaQaQaQaQaQaQaQaQaQaQaQaQ
aQaQaQaQaQaQaQaQaQaQaQaQaQaQaQaQaQaQaQaQaQaQaQaQaQaQaQaQaQaQaQaQaQaQaQaQaQaQaQaQaQaQaQaQaQaQaQaQaQaQ
aQaQaQaQaQaQaQaQaQaQaQaQaQaQaQaQaQaQaQaQaQaQaQaQaQaQaQaQaQaQaQaQaQaQaQaQaQaQaQaQaQaQaQaQaQaQaQaQaQaQ
aQaQaQaQaQaQaQaQaQaQaQaQaQaQaQaQaQaQaQaQaQaQaQaQaQaQaQaQaQaQaQaQaQaQaQaQaQaQaQaQaQaQaQaQaQaQaQaQaQaQ
aQaQaQaQaQaQaQaQaQaQaQaQaQaQaQaQaQaQaQaQaQaQaQaQaQaQaQaQaQaQaQaQaQaQaQaQaQaQaQaQaQaQaQaQaQaQaQaQaQaQ
aQaQaQaQaQaQaQaQaQaQaQaQaQaQaQaQaQaQaQaQaQaQaQaQaQaQaQaQaQaQaQaQaQaQaQaQaQaQaQaQaQaQaQaQaQaQaQaQaQaQ
aQaQaQaQaQaQaQaQaQaQaQaQaQaQaQaQaQaQaQaQaQaQaQaQaQaQaQaQaQaQaQaQaQaQaQaQaQaQaQaQaQaQaQaQaQaQaQaQaQaQ
aQaQaQaQaQaQaQaQaQaQaQaQaQaQaQaQaQaQaQaQaQaQaQaQaQaQaQaQaQaQaQaQaQaQaQaQaQaQaQaQaQaQaQaQaQaQaQaQaQaQ
aQaQaQaQaQaQaQaQaQaQaQaQaQaQaQaQaQaQaQaQaQaQaQaQaQaQaQaQaQaQaQaQaQaQaQaQaQaQaQaQaQaQaQaQaQaQaQaQaQaQ
aQaQaQaQaQaQaQaQaQaQaQaQaQaQaQaQaQaQaQaQaQaQaQaQaQaQaQaQaQaQaQaQaQaQaQaQaQaQaQaQaQaQaQaQaQaQaQaQaQaQ
aQaQaQaQaQaQaQaQaQaQaQaQaQaQaQaQaQaQaQaQaQaQaQaQaQaQaQaQaQaQaQaQaQaQaQaQaQaQaQaQaQaQaQaQaQaQaQaQaQaQ
aQaQaQaQaQaQaQaQaQaQaQaQaQaQaQaQaQaQaQaQaQaQaQaQaQaQaQaQaQaQaQaQaQaQaQaQaQaQaQaQaQaQaQaQaQaQaQaQaQaQ
aQaQaQaQaQaQaQaQaQaQaQaQaQaQaQaQaQaQaQaQaQaQaQaQaQaQaQaQaQaQaQaQaQaQaQaQaQaQaQaQaQaQaQaQaQaQaQaQaQaQ
"}

(1,1,3) = {"
bpbpbpbpbpbpbpbpbpbpbpbpbpbpbpbpbpbpbpbpbpbpbpbpbpbpbpbpbpbpbpbpbpbpbpbpbpbpbpbpbpbpbpbpbpbpbpbpbpbp
bpbpbpbpbpbpbpbpbpbpbpbpbpbpbpbpbpbpbpbpbpbpbpbpbpbpbpbpbpbpbpbpbpbpbpbpbpbpbpbpbpbpbpbpbpbpbpbpbpbp
bpbpbpbpbpbpbpbpbpbpbpbpbpbpbpbpbpbpbpbpbpbpbpbpbpbpbpbpbpbpbpbpbpbpbpbpbpbpbpbpbpbpbpbpbpbpbpbpbpbp
bpbpbpbpbpbpbpbpbpbpbpbpbpbpbpbpbpbpbpbpbpbpbpbpbpbpbpbpbpbpbpbpbpbpbpbpbpbpbpbpbpbpbpbpbpbpbpbpbpbp
bpbpbpbpbpbpbpbpbpbpbpbpbpbpbpbpbpbpbpbpbpbpbpbpbpbpbpbpbpbpbpbpbpbpbpbpbpbpbpbpbpbpbpbpbpbpbpbpbpbp
bpbpbpbpbpbpbpbpbpbpbpbpbpbpbpbpbpbpbpbpbpbpbpbpbpbpbpbpbpbpbpbpbpbpbpbpbpbpbpbpbpbpbpbpbpbpbpbpbpbp
bpbpbpbpbpbpbpbpbpbpbpbpbpbpbpbpbpbpbpbpbpbpbpbpbpbpbpbpbpbpbpbpbpbpbpbpbpbpbpbpbpbpbpbpbpbpbpbpbpbp
bpbpbpbpbpbpbpbpbpbpbpbpbpbpbpbpbpbpbpbpbpbpbpbpbpbpbpbpbpbpbpbpbpbpbpbpbpbpbpbpbpbpbpbpbpbpbpbpbpbp
bpbpbpbpbpbpbpbpbpbpbpbpbpbpbpbpbpbpbpbpbpbpbpbpbpbpbpbpbpbpbpbpbpbpbpbpbpbpbpbpbpbpbpbpbpbpbpbpbpbp
bpbpbpbpbpbpbpbpbpbpbpbpbpbpbpbpbpbpbpbpbpbpbpbpbpbpbpbpbpbpbpbpbpbpbpbpbpbpbpbpbpbpbpbpbpbpbpbpbpbp
bpbpbpbpbpbpbpbpbpbpbpbpbpbpbpbpbpbpbpbpbpbpbpbpbpbpbpbpbpbpbpbpbpbpbpbpbpbpbpbpbpbpbpbpbpbpbpbpbpbp
bpbpbpbpbpbpbpbpbpbpbpbpbpbpbpbpbpbpbpbpbpbpbpbpbpbpbpbpbpbpbpbpbpbpbpbpbpbpbpbpbpbpbpbpbpbpbpbpbpbp
bpbpbpbpbpbpbpbpbpbpbpbpbpbpbpbpbpbpbpbpbpbpbpbpbpbpbpbpbpbpbpbpbpbpbpbpbpbpbpbpbpbpbpbpbpbpbpbpbpbp
bpbpbpbpbpbpbpbpbpbpbpbpbpbpbpbpbpbpbpbpbpbpbpbpbpbpbpbpbpbpbpbpbpbpbpbpbpbpbpbpbpbpbpbpbpbpbpbpbpbp
bpbpbpbpbpbpbpbpbpbpbpbpbpbpbpbpbpbpbpbpbpbpbpbpbpbpbpbpbpbpbpbpbpbpbpbpbpbpbpbpbpbpbpbpbpbpbpbpbpbp
bpbpbpbpbpbpbpbpbpbpbpbpbpbpbpbpbpbpbpbpbpbpbpbpbpbpbpbpbpbpbpbpbpbpbpbpbpbpbpbpbpbpbpbpbpbpbpbpbpbp
bpbpbpbpbpbpbpbpbpbpbpbpbpbpbpbpbpbpbpbpbpbpbpbpbpbpbpbpbpbpbpbpbpbpbpbpbpbpbpbpbpbpbpbpbpbpbpbpbpbp
bpbpbpbpbpbpbpbpbpbpbpbpbpbpbpbpbpbpbpbpbpbpbpbpbpbpbpbpbpbpbpbpbpbpbpbpbpbpbpbpbpbpbpbpbpbpbpbpbpbp
bpbpbpbpbpbpbpbpbpbpbpbpbpbpbpbpbpbpbpbpbpbpbpbpbpbpbpbpbpbpbpbpbpbpbpbpbpbpbpbpbpbpbpbpbpbpbpbpbpbp
bpbpbpbpbpbpbpbpbpbpbpbpbpbpbpbpbpbpbpbpbpbpbpbpbpbpbpbpbpbpbpbpbpbpbpbpbpbpbpbpbpbpbpbpbpbpbpbpbpbp
bpbpbpbpbpbpbpbpbpbpbpbpbpbpbpbpbpbpbpbpbpbpbpbpbpbpbpbpbpbpbpbpbpbpbpbpbpbpbpbpbpbpbpbpbpbpbpbpbpbp
bpbpbpbpbpbpbpbpbpbpbpbpbpbpbpbpbpbpbpbpbpbpbpbpbpbpbpbpbpbpbpbpbpbpbpbpbpbpbpbpbpbpbpbpbpbpbpbpbpbp
bpbpbpbpbpbpbpbpbpbpbpbpbpbpbpbpbpbpbpbpbpbpbpbpbpbpbpbpbpbpbpbpbpbpbpbpbpbpbpbpbpbpbpbpbpbpbpbpbpbp
bpbpbpbpbpbpbpbpbpbpbpbpbpbpbpbpbpbpbpbpbpbpbpbpbpbpbpbpbpbpbpbpbpbpbpbpbpbpbpbpbpbpbpbpbpbpbpbpbpbp
bpbpbpbpbpbpbpbpbpbpbpbpbpbpbpbpbpbpbpbpbpbpbpbpbpbpbpbpbpbpbpbpbpbpbpbpbpbpbpbpbpbpbpbpbpbpbpbpbpbp
bpbpbpbpbpbpbpbpbpbpbpbpbpbpbpbpbpbpbpbpbpbpbpbpbpbpbpbpbpbpbpbpbpbpbpbpbpbpbpbpbpbpbpbpbpbpbpbpbpbp
bpbpbpbpbpbpbpbpbpbpbpbpbpbpbpbpbpbpbpbpbpbpbpbpbpbpbpbpbpbpbpbpbpbpbpbpbpbpbpbpbpbpbpbpbpbpbpbpbpbp
bpbpbpbpbpbpbpbpbpbpbpbpbpbpbpbpbpbpbpbpbpbpbpbpbpbpbpbpbpbpbpbpbpbpbpbpbpbpbpbpbpbpbpbpbpbpbpbpbpbp
bpbpbpbpbpbpbpbpbpbpbpbpbpbpbpbpbpbpbpbpbpbpbpbpbpbpbpbpbpbpbpbpbpbpbpbpbpbpbpbpbpbpbpbpbpbpbpbpbpbp
bpbpbpbpbpbpbpbpbpbpbpbpbpbpbpbpbpbpbpbpbpbpbpbpbpbpbpbpbpbpbpbpbpbpbpbpbpbpbpbpbpbpbpbpbpbpbpbpbpbp
bpbpbpbpbpbpbpbpbpbpbpbpbpbpbpbpbpbpbpbpbpbpbpbpbpbpbpbpbpbpbpbpbpbpbpbpbpbpbpbpbpbpbpbpbpbpbpbpbpbp
bpbpbpbpbpbpbpbpbpbpbpbpbpbpbpbpbpbpbpbpbpbpbpbpbpbpbpbpbpbpbpbpbpbpbpbpbpbpbpbpbpbpbpbpbpbpbpbpbpbp
bpbpbpbpbpbpbpbpbpbpbpbpbpbpbpbpbpbpbpbpbpbpbpbpbpbpbpbpbpbpbpbpbpbpbpbpbpbpbpbpbpbpbpbpbpbpbpbpbpbp
bpbpbpbpbpbpbpbpbpbpbpbpbpbpbpbpbpbpbpbpbpbpbpbpbpbpbpbpbpbpbpbpbpbpbpbpbpbpbpbpbpbpbpbpbpbpbpbpbpbp
bpbpbpbpbpbpbpbpbpbpbpbpbpbpbpbpbpbpbpbpbpbpbpbpbpbpbpbpbpbpbpbpbpbpbpbpbpbpbpbpbpbpbpbpbpbpbpbpbpbp
bpbpbpbpbpbpbpbpbpbpbpbpbpbpbpbpbpbpbpbpbpbpbpbpbpbpbpbpbpbpbpbpbpbpbpbpbpbpbpbpbpbpbpbpbpbpbpbpbpbp
bpbpbpbpbpbpbpbpbpbpbpbpbpbpbpbpbpbpbpbpbpbpbpbpbpbpbpbpbpbpbpbpbpbpbpbpbpbpbpbpbpbpbpbpbpbpbpbpbpbp
bpbpbpbpbpbpbpbpbpbpbpbpbpbpbpbpbpbpbpbpbpbpbpbpbpbpbpbpbpbpbpbpbpbpbpbpbpbpbpbpbpbpbpbpbpbpbpbpbpbp
bpbpbpbpbpbpbpbpbpbpbpbpbpbpbpbpbpbpbpbpbpbpbpbpbpbpbpbpbpbpbpbpbpbpbpbpbpbpbpbpbpbpbpbpbpbpbpbpbpbp
bpbpbpbpbpbpbpbpbpbpbpbpbpbpbpbpbpbpbpbpbpbpbpbpbpbpbpbpbpbpbpbpbpbpbpbpbpbpbpbpbpbpbpbpbpbpbpbpbpbp
bpbpbpbpbpbpbpbpbpbpbpbpbpbpbpbpbpbpbpbpbpbpbpbpbpbpbpbpbpbpbpbpbpbpbpbpbpbpbpbpbpbpbpbpbpbpbpbpbpbp
bpbpbpbpbpbpbpbpbpbpbpbpbpbpbpbpbpbpbpbpbpbpbpbpbpbpbpbpbpbpbpbpbpbpbpbpbpbpbpbpbpbpbpbpbpbpbpbpbpbp
bpbpbpbpbpbpbpbpbpbpbpbpbpbpbpbpbpbpbpbpbpbpbpbpbpbpbpbpbpbpbpbpbpbpbpbpbpbpbpbpbpbpbpbpbpbpbpbpbpbp
bpbpbpbpbpbpbpbpbpbpbpbpbpbpbpbpbpbpbpbpbpbpbpbpbpbpbpbpbpbpbpbpbpbpbpbpbpbpbpbpbpbpbpbpbpbpbpbpbpbp
bpbpbpbpbpbpbpbpbpbpbpbpbpbpbpbpbpbpbpbpbpbpbpbpbpbpbpbpbpbpbpbpbpbpbpbpbpbpbpbpbpbpbpbpbpbpbpbpbpbp
bpbpbpbpbpbpbpbpbpbpbpbpbpbpbpbpbpbpbpbpbpbpbpbpbpbpbpbpbpbpbpbpbpbpbpbpbpbpbpbpbpbpbpbpbpbpbpbpbpbp
bpbpbpbpbpbpbpbpbpbpbpbpbpbpbpbpbpbpbpbpbpbpbpbpbpbpbpbpbpbpbpbpbpbpbpbpbpbpbpbpbpbpbpbpbpbpbpbpbpbp
bpbpbpbpbpbpbpbpbpbpbpbpbpbpbpbpbpbpbpbpbpbpbpbpbpbpbpbpbpbpbpbpbpbpbpbpbpbpbpbpbpbpbpbpbpbpbpbpbpbp
bpbpbpbpbpbpbpbpbpbpbpbpbpbpbpbpbpbpbpbpbpbpbpbpbpbpbpbpbpbpbpbpbpbpbpbpbpbpbpbpbpbpbpbpbpbpbpbpbpbp
bpbpbpbpbpbpbpbpbpbpbpbpbpbpbpbpbpbpbpbpbpbpbpbpbpbpbpbpbpbpbpbpbpbpbpbpbpbpbpbpbpbpbpbpbpbpbpbpbpbp
"}
